0 0 0 0 0 0 0 0 0 0 0 0 0 0 0 0 0 0 0 0 0 0 0 0 0 0 0 0 0 0 0 0 0 0 0 0 0 0 0 0 0 0 0 0 0 0 0 0 0 0 
0 2 2 2 2 2 2 2 2 2 2 2 2 2 2 2 2 2 2 2 2 2 2 2 2 2 2 2 2 2 2 2 2 2 2 2 2 2 2 2 2 2 2 2 2 2 2 2 2 0
0 2 6 6 6 6 6 6 6 6 10 6 6 10 6 6 6 6 10 6 6 6 10 6 6 6 6 10 6 6 6 6 6 6 6 6 6 6 6 6 6 6 6 10 6 6 6 6 2 0
0 2 6 6 6 6 6 6 6 6 6 6 6 6 6 10 6 6 6 6 10 6 6 6 6 10 6 6 6 6 10 6 6 10 6 6 6 6 6 6 6 6 6 6 6 6 6 6 2 0
0 2 6 6 6 6 6 6 6 6 10 6 6 10 6 6 10 6 6 6 6 6 6 10 6 6 6 6 6 6 6 6 6 6 6 10 6 6 10 6 6 10 6 6 6 6 6 6 2 0
0 2 6 6 6 6 6 6 6 6 10 6 6 6 6 6 6 10 6 6 6 10 6 6 6 6 10 6 6 10 6 6 10 6 6 6 6 6 6 6 6 6 6 6 6 10 6 6 2 0
0 2 6 6 6 6 6 6 6 6 6 6 6 6 10 6 6 6 6 6 10 6 6 6 6 6 6 6 6 6 6 6 6 6 6 10 10 6 6 10 6 6 6 6 6 6 6 6 2 0
0 2 6 6 6 6 6 6 10 6 6 10 6 6 6 6 6 10 6 6 6 6 10 6 6 10 6 6 6 6 6 6 6 6 6 6 6 6 6 6 6 6 6 10 6 6 6 10 2 0
0 2 6 6 6 6 6 6 6 6 6 6 6 6 6 6 6 6 6 6 6 6 6 6 6 6 6 6 6 6 10 6 6 6 6 10 6 6 6 10 6 6 10 6 6 6 6 6 2 0
0 2 2 7 2 2 2 2 2 2 2 2 2 2 2 2 2 2 2 2 2 2 2 2 2 2 2 2 2 2 2 2 2 2 2 2 2 2 2 2 2 2 2 2 2 2 3 2 2 0
0 2 7 7 7 7 7 7 7 7 2 4 4 4 4 4 4 4 4 1 1 1 0 0 0 0 0 1 1 1 1 4 4 4 4 4 4 4 4 2 3 3 9 3 3 3 3 3 2 0
0 2 7 7 7 7 7 7 7 7 2 4 4 4 4 4 4 4 4 1 1 1 1 0 0 0 1 1 1 1 1 4 4 4 4 4 4 4 4 2 3 3 9 3 9 3 3 3 2 0
0 2 7 7 7 7 7 7 7 7 2 4 4 4 4 1 1 1 1 1 1 1 1 1 0 1 1 1 1 1 1 1 1 1 1 4 4 4 4 2 9 3 3 3 3 3 3 3 2 0
0 2 7 7 7 7 7 7 7 7 2 4 4 4 4 4 4 4 4 1 1 1 1 1 1 1 1 1 1 1 1 4 4 4 4 4 4 4 4 2 9 3 3 9 3 9 3 3 2 0
0 2 7 7 7 7 7 7 7 7 2 4 4 4 4 4 4 4 4 1 1 1 1 1 1 1 1 1 1 1 1 4 4 4 4 4 4 4 4 2 3 9 3 3 3 3 9 3 2 0
0 2 7 7 7 7 7 7 7 7 2 1 1 1 1 1 1 1 1 1 1 1 1 1 1 1 1 1 1 1 1 1 1 1 1 1 1 1 1 2 3 3 3 3 3 3 9 3 2 0
0 2 7 7 7 7 7 7 7 7 2 1 1 1 1 1 1 1 1 1 1 1 1 1 1 1 1 1 1 1 1 1 1 1 1 1 1 1 1 2 3 3 3 3 9 3 3 3 2 0
0 2 7 7 7 7 7 7 7 7 2 1 1 1 1 1 1 1 1 1 1 1 1 1 1 1 1 1 1 1 1 1 1 1 1 1 1 1 1 2 3 9 3 3 3 9 3 3 2 0
0 2 7 7 7 7 7 7 7 7 2 1 1 1 1 1 1 1 1 1 1 1 1 1 1 1 1 1 1 1 1 1 1 1 1 1 1 1 1 2 3 3 3 3 3 3 3 3 2 0
0 2 7 7 7 7 7 7 7 7 2 1 1 1 1 1 1 1 1 1 1 1 1 1 1 1 1 1 1 1 1 1 1 1 1 1 1 1 1 2 3 3 3 3 3 3 3 3 2 0
0 2 7 7 7 7 7 7 7 7 2 1 1 1 1 1 1 1 1 1 1 1 1 1 1 1 1 1 1 1 1 1 1 1 1 1 1 1 1 2 3 3 3 0 0 0 0 0 2 0
0 2 7 7 7 7 7 7 7 7 2 1 1 1 1 1 1 1 1 1 1 1 1 1 1 1 1 1 1 1 1 1 1 1 1 1 1 1 1 2 3 3 3 0 3 3 3 3 2 0
0 2 7 7 7 7 7 7 7 7 2 1 1 1 1 1 1 1 1 1 1 1 1 1 1 1 1 1 1 1 1 1 1 1 1 1 1 1 1 1 3 3 3 8 3 3 3 3 2 0
0 2 7 7 7 7 7 7 7 7 2 1 2 2 2 2 2 1 1 1 1 1 1 1 1 1 1 1 1 1 1 1 1 1 1 1 1 1 1 2 3 3 3 0 3 3 3 3 2 0
0 2 7 7 7 7 7 7 7 7 2 1 2 2 1 1 1 1 1 1 1 1 1 1 1 1 1 1 1 1 1 1 1 1 1 1 1 1 1 2 3 3 3 0 0 0 0 0 2 0
0 2 7 7 7 7 7 7 7 7 2 1 2 2 1 1 1 1 1 1 1 1 1 1 1 1 1 1 1 1 1 1 1 1 1 1 1 1 1 2 3 3 3 3 3 3 3 3 2 0
0 2 7 7 7 7 7 7 7 7 2 1 2 2 2 2 2 1 1 1 1 1 1 1 1 1 1 1 1 1 1 1 1 1 1 1 1 1 1 2 3 3 3 3 3 3 3 3 2 0
0 2 7 7 7 7 7 7 7 7 2 1 1 1 1 1 1 1 1 1 1 1 1 1 1 1 1 1 1 1 1 1 1 1 1 1 1 1 1 2 3 3 3 3 3 3 3 3 2 0
0 2 7 7 7 7 7 7 7 7 2 1 1 1 1 1 1 1 1 1 1 1 1 1 1 1 1 1 1 1 1 1 1 1 1 1 1 1 1 2 3 3 3 3 3 3 3 3 2 0
0 2 7 7 7 7 7 7 7 7 2 1 1 1 1 1 1 1 1 1 1 1 1 1 1 1 1 1 1 1 1 1 1 1 1 1 1 1 1 2 3 3 3 3 3 3 3 3 2 0
0 2 7 7 7 7 7 7 7 7 2 1 1 1 1 1 1 1 1 1 1 1 1 1 1 1 1 1 1 1 1 1 1 1 1 1 1 1 1 2 3 3 3 3 3 3 3 3 2 0
0 2 7 7 7 7 7 7 7 7 2 1 1 1 1 1 1 1 1 1 1 1 1 1 1 1 1 1 1 1 1 1 1 1 1 1 1 1 1 2 3 3 3 3 3 3 3 3 2 0
0 2 7 7 7 7 7 7 7 7 2 1 1 1 1 1 1 1 1 1 1 1 1 1 1 1 1 1 1 1 1 1 1 1 1 1 1 1 1 2 3 3 3 3 3 3 3 3 2 0
0 2 7 7 7 7 7 7 7 7 2 1 1 1 1 1 1 1 1 1 1 1 1 1 1 1 1 1 1 1 1 1 1 1 1 1 1 1 1 2 3 3 3 3 3 3 3 3 2 0
0 2 7 2 2 7 2 2 7 7 2 1 1 1 1 1 1 1 1 1 1 1 1 1 1 1 1 1 1 1 1 1 1 1 1 1 1 1 1 2 3 3 3 3 3 3 3 3 2 0
0 2 7 2 7 7 7 2 7 7 2 4 4 4 4 4 4 4 4 1 1 1 1 1 1 1 1 1 1 1 1 4 4 4 4 4 4 4 4 2 3 3 3 3 3 3 3 3 2 0
0 2 7 2 7 7 7 2 7 7 2 4 4 4 4 4 4 4 4 1 1 1 1 1 1 1 1 1 1 1 1 4 4 4 4 4 4 4 4 2 9 9 9 3 3 9 9 9 2 0
0 2 7 2 7 7 7 2 7 7 2 4 4 4 4 1 1 1 1 1 1 1 1 1 0 1 1 1 1 1 1 1 1 1 1 4 4 4 4 2 9 9 9 3 3 9 9 9 2 0
0 2 7 2 7 7 7 2 7 7 2 4 4 4 4 4 4 4 4 1 1 1 1 0 0 0 1 1 1 1 1 4 4 4 4 4 4 4 4 2 9 9 9 3 3 9 9 9 2 0
0 2 7 2 7 7 7 2 7 7 2 4 4 4 4 4 4 4 4 1 1 1 0 0 0 0 0 1 1 1 1 4 4 4 4 4 4 4 4 2 9 9 9 9 9 9 9 9 2 0
0 2 2 2 2 2 2 2 2 2 2 2 2 2 2 2 2 2 2 2 2 2 2 2 2 2 2 2 2 2 2 2 2 2 2 2 2 2 2 2 2 2 2 2 2 2 2 2 2 0
0 2 5 5 5 5 5 5 5 5 5 5 5 5 5 5 5 5 5 5 5 5 5 5 5 5 5 5 5 5 5 5 5 5 5 5 5 5 5 5 5 5 5 5 5 5 5 5 2 0
0 2 5 5 5 5 5 5 5 5 5 5 5 5 5 5 5 5 5 5 5 5 5 5 5 5 5 5 5 5 5 5 5 5 5 5 5 5 5 5 5 5 5 5 5 5 5 5 2 0
0 2 5 5 5 5 5 5 5 5 5 5 5 5 5 5 5 5 5 5 5 5 5 5 5 5 5 5 5 5 5 5 5 5 5 5 5 5 5 5 5 5 5 5 2 2 2 2 2 0
0 2 5 5 5 5 5 5 5 5 5 5 5 5 5 5 5 5 5 5 5 5 5 5 5 5 5 5 5 5 5 5 5 5 5 5 5 5 5 5 5 5 5 5 5 5 5 5 2 0
0 2 5 5 5 5 5 5 5 5 5 5 5 5 5 5 5 5 5 5 5 5 5 5 5 5 5 5 5 5 5 5 5 5 5 5 5 5 5 5 5 5 5 5 2 5 5 5 2 0
0 2 5 5 5 5 5 5 5 5 5 5 5 5 5 5 5 5 5 5 5 5 5 5 5 5 5 5 5 5 5 5 5 5 5 5 5 5 5 5 5 5 5 5 2 2 2 2 2 0
0 2 5 5 5 5 5 5 5 5 5 5 5 5 5 5 5 5 5 5 5 5 5 5 5 5 5 5 5 5 5 5 5 5 5 5 5 5 5 5 5 5 5 5 5 5 5 5 2 0
0 2 2 2 2 2 2 2 2 2 2 2 2 2 2 2 2 2 2 2 2 2 2 2 2 2 2 2 2 2 2 2 2 2 2 2 2 2 2 2 2 2 2 2 2 2 2 2 2 0
0 0 0 0 0 0 0 0 0 0 0 0 0 0 0 0 0 0 0 0 0 0 0 0 0 0 0 0 0 0 0 0 0 0 0 0 0 0 0 0 0 0 0 0 0 0 0 0 0 0